------------------------------------------------------------------------------------------------------------------------------------------------------
------------------------------------------------------------------------------------------------------------------------------------------------------
------------------------------------------------------------------------------------------------------------------------------------------------------
------------------------------------------------------------------------------------------------------------------------------------------------------
------------------------------------------------------------------------------------------------------------------------------------------------------
--------------------------------------------oo--oo--------------------------------ooo----------------------------------------oR-----------------------
-----------------o-----oo--------------------%%%-------------------------------------------------------------ooo--------------------------------------
--------------SS-S------#------------SSSSSS----------------------------SSSS---------S-------oo---------SS---------------------------------------------
--------------##------------------------------|SS---%%%%----------------------------------------------------------------------------------------------
------------#-##-------#----------------------------||||------------------------------------------------------------%o%%%-------SSS-----o----SSS------
-----------#####----##----------SSSS---%%%%----%%%%-||||---------%S%----------------------------------------%%%%%%--%%%|-%%%%-------------------------
-----------#####-----##-----------------||------||---|||----------|------------------------------------------||||---|||||||---------------------------
-----------#####-----##-----------------||------||--||||----------|------------------------------------------||||---|||||||---------------------------
------M----#####------#-----------------||------||--||||----------|--------------------------------------ooo-||||---|||||||-------------#-------------
------XXXXXXXXXXXXXXXXXXXXXXX---------%%%%%-%%--||--||||----------|----XXXXXXXXXXXXXXXXXXXXXXXXXXXXXXXX--%%%-||||---|||||||----XXXXXXXXXXXXXXXXXXXXXXX
------XXXXXXXXXXXXXXXXXXXXXXX---------||||------||--||||----------|----XXXXXXXXXXXXXXXXXXXXXXXXXXXXXXX----|--||||---||||||-----XXXXXXXXXXXXXXXXXXXXXXX