----------------------------------------------------------------------------------------------------------------------------------------------------------------------------------------------------------
----------------------------------------------------------------------------------------------------------------------------------------------------------------------------------------------------------
----------------------------------------------------------------------------------------------------------------------------------------------------------------------------------------------------------
----------------------------------------------------------------------------------------------------------------------------------------------------------------------------------------------------------
-------------------------------------------------------------------------------------------------------------------------------------------------------------------##-------------------------------------
---------------------------------------------------------------------------------------------------------#--------------------------------------------------------####------------------------------------
-------------------------------------SS-SS------------------------------------S!----------------S-----S#-#-----------SSSSS!S-------------------------------------######-----------------------------------
----------------------------------------SS-----------------------------------------------------------------------------------------------------------------------######-----------------------------------
-----------------------------------------------------------------------------------------------------------------------------------------------------------------#####------------------------------------
-------------------------------------------------------------------------------------------------------------------------------------------#--------------------#####-------------------------------------
-------!--------------SU--------tt--------------------------------tt------------------------@--------------------------S------------------##-------------------######--------------------!-----!----------
--------------------------------tt--------------------------------tt---------------------------------------------------------------------###--#---------------#######-------------------------------------
-----------------t--------t-----tt--------------------------------t-------------------------------------------tt------------------------####--##--------------########-----tt-----------------------------
-M--------g------tt-------t-----tt--------------------------------t-------------------------------------------tt----gg-----------------#####--##-------g-g---#######t------tt-------------------g-g---#---
XXXXXXXXXXXXXXXXXXXXXXXXXXXXXXXXXX--XXXXXX---XXXXXXXXXXXXXXXXXXXXXXXXXXXXXXXXXXXXXXXXXXXXXXXXXXXXXXXXXXXXXXXXXXXXXXXXXXXXXXXXXXXXXXXXXXXXXXXXXXXXXXXXXXXXXXXXXXXXXXXXXXXXXXXXXXXXXXXXXXXXXXXXXXXXXXXXXXXXX
XXXXXXXXXXXXXXXXXXXXXXXXXXXXXXXXXX--XXXXXX---XXXXXXXXXXXXXXXXXXXXXXXXXXXXXXXXXXXXXXXXXXXXXXXXXXXXXXXXXXXXXXXXXXXXXXXXXXXXXXXXXXXXXXXXXXXXXXXXXXXXXXXXXXXXXXXXXXXXXXXXXXXXXXXXXXXXXXXXXXXXXXXXXXXXXXXXXXXXX