----------------------------------------------------------------------------------------------------------------------------------------------------------------------------------------------------------
----------------------------------------------------------------------------------------------------------------------------------------------------------------------------------------------------------
----------------------------------------------------------------------------------------------------------------------------------------------------------------------------------------------------------
----------------------------------------------------------------------------------------------------------------------------------------------------------------------------------------------------------
----------------------------------------------------------------------------------------------------------------------------------------------------------------------------------------------------------
----------------------------------------------------------------------------------------------------------------------------------------------------------------------------------------------------------
------------------!--------!--------------------------SSSS------------------SS!----------S!S------------SS!S-------------------------------S------------------SS----SS--------------------SS---S----------
-------------------------------------------------------------------------------S------------------------------------------------------------------------------------------------------------S-------------
----------------------------------------------------------#-----------------------------------------------------------------------------------------------------------------------------------------------
----------------------------------------------------------##----------------------------------------------------------------------------------------------------------------------------------------------
----S!----------S-!------------------S--------------S--!#####-------------SS--------------------!-----------SS!S--------------------------------------SSS@S------------------------------#-----------SS---
--------------------------------------------------------######--------------------------------------------------------------------------------------------------------------------------##----------------
-------------------------------------------------------#######---ttt----------------------------------------------------ttt-----------------------------------------------------tt-----###----------------
-M-----------------------------------------------------#######----tt--------------------g--------------------------------tt------------------------g-------------------g-g--g---ttt----###-------g-g------
-XXXXXXXXXXXXXXXXXXXXX---XXXXXXXXXXXXXXXXXXXXXXXXXXXXXXXXXXXXXXXXXXXXXXXXXXXXXXXXXXXXXXXXXXXXXXXXXXXXXXXXXXXXXXXXXXXXXXXXXXXXXXXXXXXXXXXXXXXXXXXXXXXXXXXXXXXXXX------XXXXXXXXXXXXXXXXXXXXXX-----XXXXXXXXXX
-XXXXXXXXXXXXXXXXXXXXX---XXXXXXXXXXXXXXXXXXXXXXXXXXXXXXXXXXXXXXXXXXXXXXXXXXXXXXXXXXXXXXXXXXXXXXXXXXXXXXXXXXXXXXXXXXXXXXXXXXXXXXXXXXXXXXXXXXXXXXXXXXXXXXXXXXXXXX------XXXXXXXXXXXXXXXXXXXXXX------XXXXXXXXX