--------------------------------------------------------------------------------------------------------------------------------------------------------------
--------------------------------------------------------------------------------------------------------------------------------------------------------------
--------------------------------------------------------------------------------------------------------------------------------------------------------------
S----SSSSSSSSSSSSSSSSSSSSSSSSSSSSSSSSSSSSSSSSS---------------------------LS----------SSSSSSSSSSSSSSSSSSSSSSSSSSSSSSSSSSSSSSSSSSSSSSSSSSSSSSSSSSSSSSSSSSS------
S--------------------SS-----------------------------------------------------------------------SSS--SSSS----------------------------------------SSSS-----------
S--------------------SS-----------------------------------------------------------------------SSS--SSSS----------------------------------------SSSS-----------
S--------------------------o-------------------------------------------ooo----------------------------------------------------------------SS------------------
S-------------------------------------------------------------------------------------------------------------------------------------------------------------
S--------------------------SS-----------------------------------------SSSS------------------------------------------------------------------------------------
S---------------------------S-----SSSS--------------------------oo---------S--------------------oo--o---oo----------------------------------------------------
S--------------SSSSSSSSS-SSSSSS---SSSS--SS---------------SSSSSSSSSS---S---SS--------------------SSSSSS--SS---------------------------------@QQ--SSS-----------
S-----T------------------------------------------------------------------------------------------------------------------------------------------------T------
S----TTT----------------------------------------TT-----------------------------------------------------------------------------------------------------T------
SM---TTT----------------------------------------TT----#-------------g--------------------#-#-----------g------g-g------------------------------------g--------
XXXXXXXXXXXXXXXXXXXXXXXXXXXXXXXXXXXXXXXXXXXXXXXXXXXXXXXXXXXXXXXXXXXXXXXXXXXX-----XXXXXXXXXXXXXXXXXXXXXXXXXXXXXXXXXXXXX---XXXXXXXXXXXXXXXXXXXXXXXXXXXXXXXXXXXXX
XXXXXXXXXXXXXXXXXXXXXXXXXXXXXXXXXXXXXXXXXXXXXXXXXXXXXXXXXXXXXXXXXXXXXXXXXXXX----XXXXXXXXXXXXXXXXXXXXXXXXXXXXXXXXXXXXXX---XXXXXXXXXXXXXXXXXXXXXXXXXXXXXXXXXXXXX