-------------X------------------X-----------------X---------------------------------------------------------------------------------X----------------------------------------------------------------------
-------------X------------------X-----------------X---------------------------------------------------------------------------------X----------------------------------------------------------------------
-------------X------------------X-----------------X---------------------------------------------------------------------------------X----------------------------------------------------------------------
-------------X------------------X-----------------X---------------------------------------------------------------------------------X----------------------------------------------------------------------
-------------X------------------X-----------------X---------------------------------------------------------------------------------X----------------------------------------------------------------------
-------------X------------------X-----------------X---------------------------------------------------------------------------------X----------------------------------------------------------------------
-------------X------------------X-----------------X---------------------------------------------------------------------------------X----------------------------------------------------------------------
-------------X------------------X-----------------X---------------------------------------------------------------------------------X----------------------------------------------------------------------
-------------X------------------X-----------------X---------------------------------------------------------------------------------X----------------------------------------------------------------------
-------------X------------------X-----------------X---------------------------------------------------------------------------------X----------------------------------------------------------------------
-------------X------------------X-----------------X---------------------------------------------------------------------------------X----------------------------------------------------------------------
-------------X------------------X-----------------X---------------------------------------------------------------------------------X----------------------------------------------------------------------
-------------X------------------X-----------------X---------------------------------------------------------------------------------X----------------------------------------------------------------------
-------------X------------------X-----------------X---------------------------------------------------------------------------------X----------------------------------------------------------------------
-------------X------------------X-----------------X---------------------------------------------------------------------------------X----------------------------------------------------------------------
--------------------------------X-----------------X---------------------------------------------------------------------------------X----------------------------------------------------------------------
-------------X---------------------------------------------------------------------------------------------------------------------------------------------------------------------------------------------
-------------X------------------X-----------------X---------------------------------------------------------------------------------X----------------------------------------------------------------------
-------------X------------------X-----------------X---------------------------------------------------------------------------------X----------------------------------------------------------------------
-------------X------------------X-----------------X---------------------------------------------------------------------------------X----------------------------------------------------------------------
-------------X------------------X-----------------X---------------------------------------------------------------------------------X----------------------------------------------------------------------
XXXXXXXXXXXXXXXXXXXXXXXXXXXXXXXXXXXXXXXXXXXXXXXXXXXXXXXXXXXXXXXXXXXXXXXXXXXXXXXXXXXXXXXXXXXXXXXXXXXXXXXXXXXXXXXXXXXXXXXXXXXXXXXXXXXXXXXXXXXXXXXXXXXXXXXXXXXXXXXXXXXXXXXXXXXXXXXXXXXXXXXXXXXXXXXXXXXXXXXXXXX
XXXXXXXXXXXXXXXXXXXXXXXXXXXXXXXXXXXXXXXXXXXXXXXXXXXXXXXXXXXXXXXXXXXXXXXXXXXXXXXXXXXXXXXXXXXXXXXXXXXXXXXXXXXXXXXXXXXXXXXXXXXXXXXXXXXXXXXXXXXXXXXXXXXXXXXXXXXXXXXXXXXXXXXXXXXXXXXXXXXXXXXXXXXXXXXXXXXXXXXXXXX
